50 50
C C C C C C C C C C C C C C C C C C C C C C C C C C C C C C C C C C C C C C C C C C C C C C C C C C 
C F F F F F F F F F F F F F F F F F F F F F F F F F F F F F F F F F F F F F F F F F F F F F F F F C 
C F S R R R R R R R R R R S S S S S S S S S S S S S S S S S S S S S S S S S S S S S S S S S S S S C 
C F S R F F F F C F F F R S S S S S S S S S S S S S S S S S S S S S S S S S S S S S S S S S S S S C 
C F S R W W b W W W W c R S S S S S S S S S S S S S S S S S S S S S S S S S S S S S S S S S S S S C 
C F S R W W W W W W W W R S S S S S s S S S S S S S S S S S S c S S S S S S S S S S S S S S S S S C 
C F S R W W W W W W W W R O O F F O S S R R R R R R R R R R R R R R R R R R R R R R O O S S O O C C 
C F S R W W W W W W W W R S S S S S S S S S c S S S S S S S S S S S S s S S S S S c S S S S S S C C 
C F S R W W W W W W W W R S S S S S S S S S S S S S S S S S S S S S S S S S S S S S S S S S S S S C 
C F S R W W W W W W W W R S S S S S S S S S S S S S S S S S S S S S S S S S S S S S S S S S S S S C 
C F S R W W W W W W W W R S S S S S S S S S S S S S S S S S S S S S S S S S S S S S S S S S S S S C 
C F S R W W W W W W W b R s S S S S S S S S S S S S S S S S S S S S S S S S S S S S S S S S S S S C 
C F S R W W W W W W W W R S S S S S S S S S S S S S S S S S S S S S S S S S S S S S S S S S S S S C 
C F S R W W W W W W W W R S S S S S S S S S S S S S S S S S S S S S S S S S S S S S S S S S S S S C 
C F S R W W W W W W W c R R R S S S S S S S S S S S S S S S S S S S S S S S S S S S S S S S S S S C 
C F S R W W W W W W W W C S S S S S S S S S S S S S S S S S S S S S S S S S S S S S S S S S S S S C 
C F S R W W W W W W W W C C S S S S S S S S S S S S S S S S S S S S S S S S S S S S S S S S S S S C 
C F S R W W W W W W W W C S S S S S S S S S S S S S S S S S S S S S S S S S S S S S S S S S S S S C 
C F S R W W W W W W W W C S S S S S S S S S S S S S s S S S S S S S S S S S S S S S S S S S S S S C 
C F S R W W W W W W W R R R R R R R R R R R R R R R R R R R R R R R R R R R S S S S S S S S S S S C 
C O S R W W W W W W W W W S S S S S S S S S S S S S S S S S S S S S S S S S S S S S S S S S S S S C 
C O S R W W W W W W W W F F F F F F F F F F F W W W W W W W W W W W W W W W W W W W F F R F F F F C 
C O S R W W W W W W W W W W W W W W W W W W W W W W W W W W W W W W W W W W W W S S S S R F F F F C 
C O S R R R R R R R W W W W W S S S S W W W W W W W W W W W W W W W W W W W S S S S S S R F F F F C 
C O S S S S S S S R W W W W W S S W W W W W W W W W W W W W W W W W W W S S S S S S S S R F F F F C 
C O S S S S S S S R W W W W W W W W W W W W W W W W W W W W W W W W S S S S S S S S S S R F F F F C 
C O S S S S S S S R W W W W W W W W W W W W W W W W W W W W W W W W S S S S S S S S S S R F F F F C 
C O S S S S S S S R W W W W W W W W W W W W W W W W W W W W W W W W S S S S S S S S S s R F F F F C 
C O S S S S S S S R W W W W W W W W W W W W W W W W W W W W W W W W S S S S S S S S S S R F F F F C 
C O S S S S S S c R b W W W W W W W W W W W W W W W W W W W W W W W S S S S S S S S R R R F F F F C 
C O S S S S S S S R W W W W W W W W W W W W W W W W W W W W W W W W c S S S S S S R R S S S S F F C 
C O S S S S S S S R W W W W W W W W W W W W W W W W W W W W W W W W S S S S S c S R S S S S S F F C 
C O S S S S S S S R W W W W W W W W W W W W W W W W W W W W W W W W R R R R R R R R S S S S F F F C 
C O S S S S S S S R W W W W W W W W W W W W W W W W W W W W W W W W R W W W W W W W W W W F F F F C 
C O S S S S S S S R W W W W W W W W W W W W W W W W W W W W W W W W R W W W W W W W W W W F F F F C 
C O S S S S S S S R W W W W W W W W W W W W W W W W W W W W W W W W R W W W W W W W W W W F F F F C 
C O S S S S S S S R W W W W W W W W W W W W W W W W W W W W W W W W R W W W W W W W W W W F F F F C 
C O S S S S S S S R W W W W W W W W W W W W W W W W W W W W W W W W R W W W W W W W W W W F F F F C 
C O S S S S S S S R F F F F b W W W W W W W W W W W W W W W W W W W R W W W W W W W W W W R R R C C 
C O S S S S S S S R F F F F F W W W W W W W W W W W W W W W W W W W R W W W W W W W W W W R C R C C 
C O S S S S S S S R F F F F F W W W W W W W W W W W W W W W W W W W R R R R R R R R R R R R C R C C 
C O S S R R R R R R F F F F F W W W W W W W W W W W W W W W W W W W W W W b W W W W W W W W W R C C 
C O S S R F F F F F F F F F F F F F F F F b W W W W W W W W W W W W W W W W W W W W W W W W W R C C 
C O S S R F F F F F F F F F F F F b F F F F F F W W W W W W W W W W W W W W W W W W W W W W W R C C 
C O S S R F F R R R R R R R R R R R R R R R R R R R R R R R R R R R R R R R R R R R R R R R R R C C 
C O S S R F F F F F F F F F F F F F F F F F F F F F F F F F F F F F F F F F F F F F F F F F F F F C 
C O O O O O O O O F F F O O O O O O O O O O O O O O O O O O O O O O O O O O O O O O O O O O O O O C 
C F F F F F F F F c F F F F F F F F F F F F F F F F F F F F F F F F F F F c F F F F F F F F F F F C 
C F F F F F F F F F F F F F F F F F F F F F F F F F F F F F F F F F F F F F F F F F F F F F F F F C 
C C C C C C C C C C C C C C C C C C C C C C C C C C C C C C C C C C C C C C C C C C C C C C C C C C 